#Область Параметры
#Если Клиент И Сервер Тогда
	Источник = Неопределено; // Произвольный. Ссылка на выгружаемый объект источник данных
	Приемник = Неопределено; // xml-узел формируемого объекта приемника
	ВходящиеДанные = Неопределено; // Произвольный. Произвольные вспомогательные данные, переданные правилу
	// конвертации из других правил (например из правила выгрузки данных или правила конвертации свойств). Значение
	// параметра, как правило, имеет тип Структура, где ключи значений соответствуют структуре свойств объекта
	// приемника. Таким образом, при конвертации свойств (в ПКС), конвертируемые данные (или часть данных) могут быть
	// получены из этого параметра.
	ИсходящиеДанные = Неопределено; // Произвольный. Произвольные вспомогательные данные, передаваемые правилам
	// конвертации объектов свойств (ПКО).
	ПКС = Неопределено; // ссылка на правило конвертации свойств
	ПКО = Неопределено; // ссылка на правило конвертации объектов - родитель данного правила конвертации свойств
	ОбъектКоллекции = Неопределено; // ссылка на выгружаемый объект коллекции. Например, строка табличной части или
	// запись регистра или строка таблицы значений или строка результата запроса и т.д.
	Отказ = Ложь; // Булево - Если Истина, то узел свойства не добавляется в Приемник
	Значение = Неопределено; // выгруженное значение свойства источника
	КлючИЗначение = Новый Структура(); // структура, содержащая ключ и значение субконто.
	ВидСубконто = Неопределено; // вид субконто (ключ)
	Субконто = Неопределено; // значение субконто (значение)
	ИмяПКО = ""; // имя правила конвертации, по которому было произведено преобразование значения свойства источника.
	ИмяПКОВидСубконто = ""; // имя правила конвертации, по которому было произведено преобразование вида субконто.
	ПКОСвойств = Неопределено; // ссылка на правило конвертации объектов свойства, по которому было произведено
	// преобразование значения свойства источника.
	УзелСвойства = Неопределено; // xml-узел выгруженного свойства
	УзелСсылки = Неопределено; // xml-узел ссылки свойства (для ссылочных типов данных, кроме перечислений)
	УзелСубконто = Неопределено; // XML-узел выгруженного субконто
	УзелКоллекцииСвойств = Неопределено; // xml-узел коллекции свойств
#КонецЕсли
#КонецОбласти